111111111111111111111111111111111111111111111111111111111111
111111111000001111111111111111111111111111110000001111111111
111111111000001111111111111111111111111111110000001111111111
111111111000001111111111111111111111111111110000001111111111
111111111000001111111111111111111111111111110000001111111111
111111111000001111111111111111111111111111110000001111111111
111111110000001111111111111111111111111111110000001111111111
111111111000001111111111111111111111111111110000001111111111
111111111000001111111111111111111111111111110000000111111111
111111111000001111111111111111111111111111110000001111111111
111111111000001111111111111000001111111111110000001111111111
000000000000000000000000000000000000000000000000001111111111
000000000000000000000000000000000000000000000000000000000000
101010100000000000000000000000000000000000000000000000000011
111111110000000000000000000000000000000000000000000000000011
111111110000000000000000000000000000000000000000000000000000
111111110000000000000000000000000000000000000000000000000000
101010100000000000000000000000000000000000000000000000000000
000000000000000000000000000000000000000000000000000000000011
000000000000000000000000000000000000000000000000000000000011
111111111000001111111111111111111111111111110000001111111111
111111111000001111111111111111111111111111110000001111111111
111111111000001111111111111111111111111111110000001111111111
111111111000001111111111111111111111111111110000000111111111
111111111000001111111111111111111111111111110000001111111111
111111111000001111111111111111111111111111110000001111111111
111111111000001111111111111111111111111111110000001111111111
111111111000001111111111111111111111111111110000001111111111
111111111000001111111111111111111111111111110000001111111111
111111111000001111111111111111111111111111110000001111111111
111111111000001111111111111111111111111111110000001111111111
111111111000001111111111111111111111111111110000001111111111
111111111000001111111111111111111111111111110000001111111111
111111111000001111111111111111111111111111110000001111111111