111111111111111111111111111111100000111111111111111111111111
111111111111111111111111111111100000111111111111111111111111
110000000000000000000000000001100000110000000000000000000000
110000000000000000000000000001100000110000000000000000000000
000000000000000000000000000000000000000000000000000000000000
011100000000000000000000000000000000000000000000000000000000
001100000000000000000000000000000000000000000000000000000000
011100000000000000000000000000000000000000000000000000000000
000000000000000000111111111111111111111111100111111111111111
000000000000000000111000000000000000000000100000000000000000
011100000000000000001000000000000000000000100000000001001010
001100000000000000001000000000000000000000101000000001111111
011100000000000001001000000000000000000000111110000001111111
000000000000000000001000000000000000000000111100000001010010
000000000000000011101000000000000000000000101000000000000000
000000000000001011111000000000000000000000100000000000000000
011100000000000011101000000000000000000000100000001110000000
001100000000000000001000000000000000000000100000001111000000
011100000000000001001111111111111111111111100111111111111111
000000000000000000001100000000000000000000000000000000000011
000000000000000000001000010010010010010000000000000000110000
000000000000000000000000111111111111111100000000000000110000
000000000000000000000000111111111111111100000000000001111000
100000000000000000001000001001001010010000000000000000110000
100000000000000000001000000000000000000000000000000000110000
111111111111100111111000000000000000000000000000000010111000
000000000000000000011111110000000000000000000000000000110000
001110000000000000011111111000000000000000000000000001110000
011110000000000000011000000000000000000000000000000000110000
001110000000000000001100000000000001110000000000000000111000
000000000000011100001100000000000001110000000000000000110000
000000000000011100001100000000000000000000000000000000110000
000000000000011100001000000000000000000000000000000100000011
000000000000001000001001111000000000000000000000000000000111