111111111111111111111111111111111111111111111111111111111111
111111111111111111111111111111111111111111111111111111111111
000000000000000000000000000000000000000000000000000000000000
000000000000000000000000000000000000000000000000000000000000
000000000000000000000000000000001110000000000000000000000000
000000000000000000000000000000001110000000000000000000000000
000000000000000000000000000000001110000000000000000000000000
111000000000000000000000000000000000000000000000000000000111
111000000000000000000000000000000000000000000000000000000111
111000001111110000000011100000000000000000000011111100000111
111000001111110000000011100000000000000000000011111100000111
111000001111110000000011100000000011100000000011111100000111
111000001111110000000000000000000011100000000011111100000111
111000001111110000000000000000000011100000000011111100000111
111000001111110000000000000000000000000000000011111100000111
111000001111110000000000000000000000000000000011111100000111
110000001111110000011100000000000000011100000011111100000011
110000001111110000011100000000000000011100000011111100000011
110000001111110000000000000000000000000000000011111100000011
110000001111110000000000000000000000000000000011111100000011
111000001111110001111111111111111111111111000011111100000111
111000001111110001111111111111111111111111000011111100000111
111000001111110001111111111111111111111111000011111100000111
111000001111110001111111111111111111111111000011111100000111
111000001111110001111111111111111111111111000011111100000111
111000001111110001111111111111111111111111000011111100000111
111000001111110001111111111111111111111111000011111100000111
111000001111110000000000000000000000000000000011111100000111
111000001111110000000000000000000000000000000011111100000111
000000001111110000000000000000000000000000000011111100000000
000000000000000000000000000000000000000000000000000000000000
000000000000000000000000000000000000000000000000000000000000
000001111111111110000111111111111111111000011111111111100000
000001111111111110000111111111111111111000011111111111100000